111111111111111111
100P00000000010001
100001111C0001E001
100011000000010001
111111111111111111